type octile
height 39
width 90
map3
..........................................................................................
..........................................................................................
..........................................................................................
..........................................................................................
..........................................................................................
..........................................................................................
..........................................................................................
..........................................@@@@@...........................................
......@@@@@.................................................@@@@@.........................
..........................................................................................
..........................@@@@@@@@@@@@@@@@@@@@@@@@@@@@@@@@@@@@@@@@@@@@@@@@@@@@@@@@@@@@@@@@
@@@@@@@@@@@@@@@@@@@@.@@@@@@@@@@@@@@@@@@@@@@@@@@@@@@@@.....................................
........................................@@@@@..............@@@@@@.........................
............@@@@@@@@.@@@@@@@@@@@@@@@@@@@@@@@@@@@@@@@@@@@@@@@@@@@@@@@@@@@@@@@@@@@@@@@@@@@@@
@@@@@@@@@@@@@@@@@@@@.@@@@@@@@@@@@@@@@@@........................................@@@@@@.....
........................@@@@@@@@@@@@@@@@@@@@@@@@@@@....................................@@@
@@@@@@@@@@@@@@@@@@@@.@@@@@@@@@@@@@@@@@@@@@@@@@@@@@@@@@@@@@@@@@@@@@@@@@@@@@@@@@@@@@@@@@@@@@
@@@@@@@@@@@@@@@@@@@@.@@@@.......................................@@@@@@@@@@@@@@....@@@@@...
..........@@@@@@@@@@.@@@@@@@@@@@@@@@@....................................@@@@@@@@@@@@@@@@@
@@@@@@@@@@@@@@@@@@@@.@@@@@@@@@@@@@@@@@@@@@@@@@@@@@@@@@@@@@@@@@@@@@@@@@@@@@@@@@@@@@@@@@@@@@
@@@@@@@@@@@.......................................@@@@@@@@@@@@@@@@@@@@@@@@............@@@@
@@@@@@@@@@@@@@@@@@@@.@@....................................@@@@@@@@@@@@@@@@@@@@@@@@@@@@@@@
@@@@@@@@@@@@@@@@@@@@.@@@@@@@@@@@@@@@@@@@@@@@@@@@@@@@@@@@@@@@@@@@@@@@@@@@@@@@@@@@@@@@@@@...
....................................@@@@@@@@@@@@@@@@@@@@@@@@............@@@@@@@@@@@@@@@@@@
@@@@@@@@@....................................@@@@@@@@.....................................
..........@@@@@...............................................@@@@@@@@@@..................
....................@@@@@@@@@@@@@@@@@@@@@@@@............@@@@@@@@@@@@@@@@@@@@@@@@@@@.......
.............................@@@@@@@@................................................@@@@@
..............................................@@@@@@@@@@@@................................
.....@@@@@@@@@@@@@@@@@@@@@@@@............@@@@@@..............@@@@@@.......................
.............@@@@@@@@@@...............................................@@@@@...............
...............................@@@@@@@@@@@@.......................................@@@@@@..
@@@@@@@@@@@@@@@............@@@@@.........................................................@
@@@@@@@@@...............................................@@@@@.............................
...............@@@@@@@@@@@@@@.....................................................@@@@@@@.
............@@@@@.........................................................@@@@@@@@@@@.....
.........................................@@@@@............................................
.@@@@@@@@@@@@@@......................................................@@@@@..............@@
@@@.........................................................@@@@@@@@@@@...................