type octile
height 3
width 3
teste_children
...
...
...