type octile
height 5
width 5
test_map_5
@@..@
.....
@@@@@
..@@.
@.@.@