type octile
height 14
width 26
test_map_1
.........@@@@@@@@@@@@@@@@@
@@@@@@@@.......@@@@@@@@@@@
@@@@@@@@@......@@@@@@@@@@@
@@@@@@@@@......@@@@@@@@@@@
......................@@@@
....................@@@@@@
.@@@@@.................@@@
.@@@@@@@@@@@@@@@@@@.......
....@@..@@@@@@@@@@@@@@@@@@
..........................
..........................
@@@@@@@@@@@@@@@@@@@@......
@@@@@@....................
.......@@@@@@@@@@@@@@@@@@@